########################
#                     B#
# #################### #
# ##                 # #
# ## #############   # #
#    #               # #
#### # ############### #
#A   #                 #
########################